4 5 S 1 1 1 1 1 1 1 1 1 1 1 1 1 1 1 1
6 7 s 1 1 1 1 1 1 1 1 1 1 1 1 1 1 1 1
5 1 s s s s s s s s s s s s s s s s 1
7 1 1 1 1 1 1 1 1 1 1 1 1 1 1 1 1 s 1
5 1 1 1 1 1 1 1 1 1 1 1 1 1 1 1 1 s 1
7 1 1 1 s s s s s s s s s s s s s s 1
5 1 1 1 s 8 8 8 8 8 8 8 8 8 8 8 8 0 0
7 1 1 1 s 8 8 8 8 8 8 8 8 8 8 8 8 0 0
5 1 1 1 s s s s s s s s s s s s s s 1
7 1 1 1 2 2 2 2 2 2 2 2 2 2 2 2 2 s 1
5 1 1 1 1 1 1 1 1 1 1 1 1 1 1 1 1 s 1
7 1 1 1 1 1 1 1 1 1 1 1 1 1 1 1 1 s 1
5 1 1 1 1 1 1 1 1 1 1 1 1 1 1 1 1 s 1
7 1 1 1 1 1 1 1 1 1 1 1 1 1 1 1 1 s 1
E s s s s s s s s s s s s s s s s s 1
8 8 8 8 8 8 8 8 8 8 8 8 8 8 8 8 8 8 8
8 8 8 8 8 8 8 8 8 8 8 8 8 8 8 8 8 8 8